@ 1
% size 10 10
# 1 w
# e goblin
# p p
% map
1111111111
1000000001
10e0000001
1000000001
1111111001
10000p0001
1000000001
1000000001
1000000001
1111111111
% end